Humans: 200
LLLLLLLLLLLLLLLLLLLLLLLLLLLLLLLLLLLLLLLLLLLLLLLLLLLLLLLLLLLLLLLLLLLLLLLLLLLLLLLLLLLLLLLLLL
L........................................................................................L
L.@......................................................................................L
L........................................................................................L
L........................................................................................L
L............RRRGGGRRR........RRRRRRRRRRRR..........GGGGGGGGGGGGGGGGGGGGGGGGGGGGG........L
L............R.......R........G..........G..........R..............R............R........L
L............G.......R........R.....................G....................................L
L............R...........................R..........R..............R............R........L
L............G.......R........R.....GGGGRR..........G...........................G........L
L............RGRGRGRGR........G..........G..........R..............R............R........L
L.............................RRRRRRRRRRRR..........GGGGGG..GGGGGGGGGGGGGGGGGGGGG........L
L........................................................................................L
L........................................................................................L
L........................................................................................L
L........................................................................................L
L.......RRRR.RRRRRRRRR.RRRRRRRRRR.RRRR...................................................L
L.......R............................R...................................................L
L.......R............................R...................................................L
L.......RRRR.RRRRRRRRR.RRRRRRRRRR.RRRR............R.....................R................L
L.................................................R............RRRRRRRRRR................L
L.................................................R............R........R................L
L.......RRRRRRRRRRRRRRRRRRRRRRRRRRRRRR............R............R........R................L
L.......R...........R................R............R.....................R................L
L.......R................R...........R............RRRRRRRRRRRRRRRRRRRRRRR................L
L.......RRRRRR..RRRRRRRRRRRRRR..RRRRRR...................................................L
L........................................................................................L
L........................................................................................L
L....................................................................................Z...L
L........................................................................................L
LLLLLLLLLLLLLLLLLLLLLLLLLLLLLLLLLLLLLLLLLLLLLLLLLLLLLLLLLLLLLLLLLLLLLLLLLLLLLLLLLLLLLLLLLL